MMMMMMMMMMMMMMMMMMMMMMMMMMMMMM
M                            M
M                            M
M                            M
M                            M
M                            M
M                            M
M                            M
M                            M
M                            M
M                            M
M                            M
M                            M
M                            M
M                            M
M                            M
M                            M
M                            M
M      MMMMMMMMMMMMMM        M
M                            M
MMMMMMMMMMMMMMMMMMMMMMMMMMMMMM
